0,	0,	0,	0,	0,	0,	0,	0,	0,	0,	0,	0,	0,	0,	0,	0,	0,	0,	0,	0,	0,	0
0,	3,	3,	1,	1,	1,	1,	1,	1,	1,	1,	1,	1,	1,	1,	1,	1,	3,	5,	3,	3,	0
0,	4,	3,	1,	3,	3,	3,	3,	3,	3,	3,	3,	3,	3,	3,	3,	1,	3,	3,	3,	6,	0
0,	4,	3,	1,	3,	5,	3,	3,	4,	4,	4,	4,	3,	3,	5,	3,	1,	3,	3,	3,	1,	0
0,	4,	3,	1,	3,	3,	3,	3,	4,	4,	4,	4,	3,	3,	3,	3,	1,	3,	3,	3,	1,	0
0,	3,	3,	1,	3,	3,	3,	3,	3,	3,	3,	3,	3,	3,	3,	3,	1,	3,	3,	3,	1,	0
0,	3,	3,	2,	3,	3,	3,	3,	3,	3,	3,	3,	3,	3,	3,	3,	1,	3,	3,	3,	1,	0
0,	3,	3,	3,	3,	3,	3,	3,	3,	3,	3,	3,	3,	3,	3,	3,	1,	3,	3,	3,	1,	0
0,	3,	3,	3,	3,	3,	3,	3,	3,	3,	3,	3,	3,	3,	3,	3,	1,	3,	3,	3,	1,	0
0,	3,	3,	3,	3,	3,	3,	3,	3,	3,	3,	3,	3,	3,	3,	3,	1,	3,	3,	3,	1,	0
0,	3,	3,	3,	3,	3,	3,	3,	3,	3,	3,	3,	3,	3,	3,	3,	1,	3,	3,	3,	1,	0
0,	3,	3,	3,	3,	3,	3,	3,	3,	3,	3,	3,	3,	3,	3,	3,	1,	3,	3,	3,	1,	0
0,	3,	3,	3,	3,	3,	3,	3,	3,	3,	3,	3,	2,	1,	1,	1,	1,	1,	1,	1,	1,	0
0,	0,	0,	0,	0,	0,	0,	0,	0,	0,	0,	0,	0,	0,	0,	0,	0,	0,	0,	0,	0,	0
